NO ./textures/test3.xpm
SO ./textures/test3.xpm
EA ./textures/test3.xpm
WE ./textures/test3.xpm
F  50,205,50
C 137,186 ,243 
        1111111111111111111111111
        1000000000110000100000001
        1011000001110000100010001
        1001000000000000100010001
111111111011000001110000100010001
100000000011000001110111100011111
11110111111111011100000010001
11110111111111011101010000001
11000000110101011100000010001
10000000000000001100000010001
10000000000000001101010010001
11000001110101011111011110101
11110111 1110101 1011110100N1
11111111 1111111 111111111111