NO ./textures/test2.xpm
SO ./textures/test3.xpm
EA ./textures/test1.xpm
WE ./textures/test4.xpm
F  50,205,50
C 137,186 ,243 
        11111111111111111111111111111111111111111111111111111111111111111111111111111111111111111
        10000000001100001000000000000000000000000000000000000000000000000000000000000000000000001
        10110000011100001000100011111111111111111111111111111111111111111111111111111111111111111
        1001000000000000100010001
111111111011000001110000100010001
100000000011000001110111100011111
11110111111111011100000010001
11110111111111011101010000001
11000000110101011100000010001
10000000000000001100000010001
10000000000000001101010010001
11000001110101011111011110101
11110111 1110101 1011110100N1
11111111 1111111 111111111111