NO ./textures/test2.xpm
SO ./textures/test3.xpm
EA ./textures/test1.xpm
WE ./textures/test4.xpm
F  92,64, 51
C 137,186 ,243 
1111111111111111
1000000000000001
1000000100000001
1000001W00000001
1000000100000001
1000000000000001
1000000000000001
1111111111111111
