EA ./path_to_the_east_texture
EA ./path_to_the_east_texture
WE ./path_to_the_west_texture
NO ./path_to_the_north_texture
 SO     	 ./path_to_the_south_texture
F 220,100,0
C 225,30,0








1111111111111111
100000010N000001
1000000000000111
1111111111111111
 
  
111111
100010 1
100011
11111