NO textures/test2.xpm
SO textures/test3.xpm
WE textures/test4.xpm
EA textures/test1.xpm
F  92,64, 51
C 137,186 ,243 

1111111111111
1N00000010001
100000D0D0001
1000000010001
1111111111111
 
 
 
D
 
 