


WE               ./path_to_the_west_texture1

SO                            ./path_to_the_south_texture1                      

F             220,100,011111111111                         

      NO ./path_to_the_north_texture_pa_puta1


EA                ./path_to_the_east_texture1                 				            


C           225,30,011111231231231231                 










2211111111111111111111111112
1000000000110000000000001
1011000001110000000000001

1001000000000000000000001				
111111111011000001110000000000001
10000000001100000111011111111111111111111111111111111111111111111111111111111111
1111011111111101110000001000100000000000000000000000000000000000000000000000

11110111111111011101010010001
11000000110101011100000010001


10000000000000001101010010001
10000000000000001101010010001
11000001110101011111011110N0111
11110111 1110101 101111010001             
11111111 1111111 111111111111			1





