NO ./textures/test2.xpm
SO ./textures/test3.xpm
EA ./textures/test1.xpm
WE ./textures/test4.xpm
F  92,64, 51
C 137,186 ,243 
        11111111111111111111111111111111111111111111111111111111111111111111111111111111111111111
        10000000001100001000000000000000000000000000000000000000000000000000000000000000000000001
        10110000011100001000100011100000000000000000000000000000000000000000000000000000000000001
        10010000000000001000100011100000000000000000000000000000000000000000000000000000000000001
1111111110110000011100001000100011100000000000000000000000000000000000000000000000000000000000001
1000000000110000011101111000111111100000000000000000000000000000000000000000000000000000000000001
1111011111111101110000001000111111100000000000000000000000000000000000000000000000000000000000001
1111011111111101110101000000111111100000000000000000000000000000000000000000000000000000000000001
1100000011010101110000001000111111100000000000000000000000000000000000000000000000000000000000001
100000000000000011000001000111111100000000000000000000000000000000000000000000000000000000000001
1000000000000000110101001000111111100000000000000000000000000000000000000000000000000000000000001
1100000111010101111101111010111111100000000000000000000000000000000000000000000000000000000000001
11110111 1110101 1011110100N111111100000000000000000000000000000000000000000000000000000000000001
11111111 1111111 11111111111111111111111111111111111111111111111111111111111111111111111111111111