NO ./textures/test2.xpm
SO ./textures/test3.xpm
EA ./textures/test1.xpm
WE ./textures/test4.xpm
F  92,64, 51
C 137,186 ,243 
111111111111111111111111111111111111111111111111111111111111111111111111111111111111111111111111111111111111111111111111111111111111111111
100000000000000000000000000000000000000000000000000000000000000000000000011111111111111111111111111111111111111111111111111111111111111111
100000010000000000000000000000000000000000000000000000000000000000000000011111111111111111111111111111111111111111111111111111111111111111
1000001N000000000000000000000000000000000000000000000000000000000000000011111111111111111111111111111111111111111111111111111111111111111
100000010000000000000000000000000000000000000000000000000000000000000000011111111111111111111111111111111111111111111111111111111111111111
100000000000000000000000000000000000000000000000000000000000000000000000011111111111111111111111111111111111111111111111111111111111111111
100000000000000000000000000000000000000000000000000000000000000000000000011111111111111111111111111111111111111111111111111111111111111111
111111111111111111111111111111111111111111111111111111111111111111111111111111111111111111111111111111111111111111111111111111111111111111
