EA ./path_to_the_east_texture
EA ./path_to_the_east_texture
WE ./path_to_the_west_texture
NO ./path_to_the_north_texture
SO ./path_to_the_south_texture
F 220,100,0
C 225,30,0
111111111111111111111111111111111111111111111111111111111111111111111111111111111111111111111111111111111111111111111111111111111111111111
100000000000000000000000000000000000000000000000000000000000000000000000011111111111111111111111111111111111111111111111111111111111111111
100000010000000000000000000000000000000000000000000000000000000000000000011111111111111111111111111111111111111111111111111111111111111111
1000001N1000000000000000000000000000000000000000000000000000000000000000011111111111111111111111111111111111111111111111111111111111111111
100000010000000000000000000000000000000000000000000000000000000000000000011111111111111111111111111111111111111111111111111111111111111111
100000000000000000000000000000000000000000000000000000000000000000000000011111111111111111111111111111111111111111111111111111111111111111
100000000000000000000000000000000000000000000000000000000000000000000000011111111111111111111111111111111111111111111111111111111111111111
111111111111111111111111111111111111111111111111111111111111111111111111111111111111111111111111111111111111111111111111111111111111111111
